11 11
9 4 
XXXXXXXXXXX
XXX...tX..X 
XXX.XXXX.XX 
XX.......X 
XXXXXXXX.XX 
X....XXX.XX 
X.XX.....XX
xX...XXXXXX 
XXXX..XXXXX 
XXXXX....XX 
XXXXXXXXXXX