15 15
1 2 
XXXXXXXXXXXXXXX
XX.XXXXXX....XX
XX....XXX.XX.XX
XXXX.XXXX....XX
XX...XXXX.XX.XX
XXXX.X....XX.XX
XXX..X.XXXXX.XX
XXX.XX.XX....XX
XXX....XX.XXXXX
XXXXXXXXX...XXX
XXX.......XXXXX
XXX.XX.XXX...XX
XXX....XXX.X.XX
XXXXXX.....XtXX
XXXXXXXXXXXXXXX
